-                               *      -
-                                      -
-                                      -
-                                      -
-                                      -
- ? ? ? ? ? ? ? ? ? ? ? ? ? ? ? ?B?B?B?-
-                                      -
-                                      -
-                                      -
-? ? ? ? ? ? ? ? ? ? ? ? ? ? ? ? ? ? ? -
-                                      -
-                                      -
- ? ? ? ? ? ? ? ? ? ? ? ? ? ? ? ? ? ? ?-
-                                      -
-                                      -
-  M                                   -
----------------------------------------